****************
*P*       O    *
* ******** * * *
* * * * * * *  *
* * * * * * *  *
*   * * *   *  *
****************