***********
*P*       O*
* ******** * *
* * * * * * * *
* * * * * * * *
*   * * *   *
***********