******************************
*P                           *
*                            *
*                            *
*                            *
*                            *
*                            *
*                            *
*                            *
*              O             *
*                            *
*                            *
*                            *
*                            *
*                            *
*                            *
*                            *
*                            *
*                            *
******************************
