******************************
*              P             *
*                            *
*                            *
*                            *
*                            *
*                            *
*                            *
*                            *
*              O             *
*                            *
*                            *
*                            *
*                            *
*                            *
*                            *
*                            *
*                            *
*                            *
******************************
